R 800 600
F        216      ,      191    ,      216
C     255     ,     192     ,     203
WE ./textures/wood.xpm
EA ./textures/new_wall.xpm
NO ./textures/eagle.xpm
SO ./textures/purplestone.xpm
S ./textures/pillar.xpm

11111111111111111111111
122222222222222222221
122222222222222222221
100000000000000000001
100000000000000000001
100000000000000000001
100000000000000000001
100000000000000000001
100000000000000000001
100000000000000000001
100000000000000000001
100000000000000000001
1000000000000000000N1
111111111111111111111