R 1024 768
   F        216     ,     191    ,    216
    C     255     ,     192     , 255
WE ./textures/ROCKRED3.xpm
EA ./textures/SP_ROCK2.xpm




NO ./textures/SKINEDGE.xpm
SO ./textures/MARBFACE.xpm






S ./textures/portal.xpm


11111111111  111111111
10222200001  1E0000021
10000000001  100000001
10000000001  111111111
11111111111




